ID,P1H,P2H,P3H,P4H,P5H,P1V,P2V,P3V,P4V,P5V,Plus_Off,Minus_Def,Plus/Minus,Home_Poss_Off,Home_Poss_Def,Poss_Tot,Time
16261572011432019501627759162836916283841628401162840416289691628973,1626157,1628384,1628404,1628969,1628973,201143,201950,1627759,1628369,1628401,19,12,7,12,11,23,3250
201143162838416284041628969162897316283691628401162843616302021630579,1628384,1628404,1628969,1628973,201143,1628369,1628401,1630579,1628436,1630202,2,2,0,3,4,7,910
201143162836916284041628969162897316284011628436163020216305401630579,1628404,1628969,1628973,201143,1628369,1628401,1630579,1628436,1630202,1630540,0,2,-2,1,0,1,130
1628369162840116284041628969162897316284361630202163054016305731630579,1628404,1628969,1628973,1628369,1628401,1630579,1628436,1630202,1630540,1630573,15,7,8,7,8,15,2690
162836916284361628969163020216305402019501626157162616616283841630573,1628969,1628369,1628436,1630202,1630540,1630573,1626157,1626166,1628384,201950,13,7,6,6,6,12,1610
16261571626166162896916305401630573201143201950162775916283841630214,1628969,1630540,1630573,1626157,1626166,1628384,201950,201143,1627759,1630214,0,4,-4,3,3,6,870
16261571626166162838416305401630573201143201950162775916302141642359,1630540,1630573,1626157,1626166,1628384,201950,201143,1627759,1630214,1642359,11,7,4,8,7,15,2550
1627759162840416289731630540164235916283691628401162843616302021630579,1630540,1627759,1642359,1628404,1628973,1630579,1628369,1628401,1628436,1630202,0,2,-2,0,1,1,330
1627759162840416289731630540163057916283691628401162843616289691630202,1630540,1627759,1628404,1628973,1630579,1628369,1628401,1628436,1630202,1628969,13,6,7,5,4,9,1500
16277591628369162840116284041628973201143201950162615716283841628969,1627759,1628404,1628973,1628369,1628401,1628969,1626157,1628384,201143,201950,32,27,5,18,19,37,5890
1628369162840116289691630540163057916261661628384162843616302021630573,1628369,1628401,1628969,1630540,1630579,1628436,1630202,1630573,1626166,1628384,6,8,-2,4,4,8,1279
162836916284361628969163054016305792019501626166162838416302021630573,1628369,1628969,1630540,1630579,1628436,1630202,1630573,1626166,1628384,201950,2,3,-1,3,2,5,591
16261661628969163054016305731630579201143201950162775916283841630214,1628969,1630540,1630579,1630573,1626166,1628384,201950,201143,1627759,1630214,8,4,4,3,4,7,1260
16261661628384162896916305401630579201143201950162775916302021630214,1628969,1630540,1630579,1626166,1628384,201950,201143,1627759,1630214,1630202,7,2,5,3,3,6,790
201950162616616283841630540163057916277591628436163020216302141642359,1630540,1630579,1626166,1628384,201950,1627759,1630214,1630202,1642359,1628436,2,5,-3,4,4,8,1500
1626166163020216302141630540163057916284361630573163057416417751642359,1630540,1630579,1626166,1630214,1630202,1642359,1628436,1630574,1630573,1641775,0,2,-2,1,1,2,410
1626166163020216302141630579164235916284361630573163057416417751642278,1630579,1626166,1630214,1630202,1642359,1628436,1630574,1630573,1641775,1642278,0,7,-7,3,2,5,640
1626166163020216302141630579164235916296741630573163057416417751642278,1630579,1626166,1630214,1630202,1642359,1630574,1630573,1641775,1642278,1629674,2,2,0,3,3,6,930
1630202163021416305741630579164235916296741630573163121016417751642278,1630579,1630214,1630202,1642359,1630574,1630573,1641775,1642278,1629674,1631210,0,0,0,4,5,9,1670
201144203497254420307620394416261561629060163016216301831630559,201144,203497,203944,1630162,1630183,2544,203076,1626156,1629060,1630559,11,7,4,11,11,22,3160
201144203497203944163016216301832030761626156162906016305591631108,201144,203497,203944,1630162,1630183,203076,1626156,1629060,1630559,1631108,2,0,2,0,1,1,380
20307620349716261561630162163018316289781629060162967516305591631108,203497,1630162,1630183,203076,1626156,1629060,1630559,1631108,1628978,1629675,3,3,0,2,1,3,570
20307620349716290601630162163018316289781629216162967516305591631108,203497,1630162,1630183,203076,1629060,1630559,1631108,1628978,1629675,1629216,2,3,-1,3,4,7,1260
20307620349716289781630162163110825441629216162963716296381629675,203497,1630162,203076,1631108,1628978,1629675,1629216,1629638,2544,1629637,2,2,0,2,1,3,510
20307616289781629675163016216311082544203944162921616296371629638,1630162,203076,1631108,1628978,1629675,1629216,1629638,2544,1629637,203944,0,3,-3,2,3,5,640
162897816292161629675163016216311082544203944162615616296371629638,1630162,1631108,1628978,1629675,1629216,1629638,2544,1629637,203944,1626156,2,5,-3,4,2,6,680
25441628978162963716296381629675201144203944162615616290601642261,1628978,1629675,1629638,2544,1629637,203944,1626156,201144,1629060,1642261,12,4,8,5,6,11,2070
25441626156162897816296371629675201144203497162906016301831642261,1628978,1629675,2544,1629637,1626156,201144,1629060,1642261,203497,1630183,3,2,1,2,1,3,590
2011441626156162897816290601629675203076203497163018316305591642261,1628978,1629675,1626156,201144,1629060,1642261,203497,1630183,203076,1630559,2,0,2,0,0,0,100
2011441626156162897816290601629675203076203497163016216305591642261,1628978,1629675,1626156,201144,1629060,1642261,203497,203076,1630559,1630162,4,0,4,3,3,6,360
2034971628978162906016296751642261203076204060162921616301621630559,1628978,1629675,1629060,1642261,203497,203076,1630559,1630162,204060,1629216,6,3,3,5,5,10,1290
203076203497162906016305591642261203944204060162921616296381630162,1629060,1642261,203497,203076,1630559,1630162,204060,1629216,203944,1629638,2,3,-1,0,1,1,390
203076203497163016216305591642261254420394420406016296381642355,1642261,203497,203076,1630559,1630162,204060,203944,1629638,2544,1642355,2,7,-5,6,5,11,1610
203076203497204060163016216305592544203944162615616296381631108,203497,203076,1630559,1630162,204060,203944,1629638,2544,1626156,1631108,2,0,2,3,3,6,790
203076203497203944163016216305592544201144162615616290601630183,203497,203076,1630559,1630162,203944,2544,1626156,201144,1630183,1629060,9,5,4,7,7,14,2140
203076203497203944163016216305592544201144162615616289781629060,203497,203076,1630559,1630162,203944,2544,1626156,201144,1629060,1628978,0,6,-6,2,3,5,870
203076203497203944163016216305592011441626156162897816290601631108,203497,203076,1630559,1630162,203944,1626156,201144,1629060,1628978,1631108,2,1,1,2,2,4,420
2030762034972039441630162163055916261561628978162906016296381631108,203497,203076,1630559,1630162,203944,1626156,1629060,1628978,1631108,1629638,2,0,2,2,1,3,480
20307620349716261561630162163055916289781629060162963816296751631108,203497,203076,1630559,1630162,1626156,1629060,1628978,1631108,1629638,1629675,2,7,-5,2,3,5,720
20307620349716290601630162163055916289781629216162963816296751631108,203497,203076,1630559,1630162,1629060,1628978,1631108,1629638,1629675,1629216,2,2,0,1,1,2,400
20307620349716290601630162163055916289781629216162963816296751642261,203497,203076,1630559,1630162,1629060,1628978,1629638,1629675,1629216,1642261,5,2,3,2,1,3,370
20307616289781629638162967516301622544203944162921616296371642261,203076,1630162,1628978,1629638,1629675,1629216,1642261,203944,2544,1629637,5,9,-4,7,8,15,1800
25441629637162963816296751642261201144203497162615616290601630183,1629638,1629675,1642261,2544,1629637,201144,203497,1630183,1626156,1629060,3,7,-4,3,2,5,890
25442011441629637162963816296752034971626156162906016301831630559,1629638,1629675,2544,1629637,201144,203497,1630183,1626156,1629060,1630559,0,0,0,1,1,2,510
25442011442034971629637162967516261561628978162906016301621630559,1629675,2544,1629637,201144,203497,1626156,1629060,1630559,1628978,1630162,6,0,6,2,3,5,640
254416261561629060162963716296752039441628978162963816301621630559,1629675,2544,1629637,1626156,1629060,1630559,1628978,1630162,203944,1629638,1,3,-2,2,1,3,870
16261561628978162906016296751630559203076203944162921616296381630162,1629675,1626156,1629060,1630559,1628978,1630162,203944,1629638,203076,1629216,7,4,3,4,5,9,1270
2039441626156162897816301621630559254420307620349716292161629638,1626156,1630559,1628978,1630162,203944,1629638,203076,1629216,203497,2544,8,7,1,5,4,9,1720
2039441626156162897816301621630559254420307620349716290601629638,1626156,1630559,1628978,1630162,203944,1629638,203076,203497,2544,1629060,3,6,-3,3,4,7,1030
20394416261561628978163016216305592544203076162906016296381629675,1626156,1630559,1628978,1630162,203944,1629638,203076,2544,1629060,1629675,0,2,-2,2,1,3,270
201939203110203924203952162901416290281630166163022816312181641739,201939,203110,203952,1630228,1631218,203924,1629014,1629028,1630166,1641739,12,5,7,11,11,22,3140
201939203110203924203952163121816277411629028163016616307031641739,201939,203110,203952,1631218,203924,1629028,1630166,1641739,1627741,1630703,2,2,0,3,3,6,670
201939203110203924203952162902816277411627780163016616307031641739,201939,203110,203952,203924,1629028,1630166,1641739,1627741,1630703,1627780,2,2,0,2,1,3,450
201939162774116290281630166164173916261721627780163070316312001641764,201939,1629028,1630166,1641739,1627741,1630703,1627780,1626172,1641764,1631200,2,6,-4,3,4,7,860
201939162774116277801629028163070316261721629014163120016417121641764,201939,1629028,1627741,1630703,1627780,1626172,1641764,1631200,1629014,1641712,0,0,0,1,0,1,90
1626172162774116277801629028163070316290011629014163120016417121641764,1629028,1627741,1630703,1627780,1626172,1641764,1631200,1629014,1641712,1629001,0,0,0,2,3,5,630
1626172162774116277801630703164176416290011629014163120016417121642270,1627741,1630703,1627780,1626172,1641764,1631200,1629014,1641712,1629001,1642270,1,3,-2,1,0,1,370
162617216277411630703163120016417642039371629001162901416417121642270,1627741,1630703,1626172,1641764,1631200,1629014,1641712,1629001,1642270,203937,2,3,-1,3,3,6,938
162617216290141630703163120016417642039371627780162900116417121642270,1630703,1626172,1641764,1631200,1629014,1641712,1629001,1642270,203937,1627780,0,0,0,0,1,1,52
16261721629001162901416307031641712203924203937163022816305411642270,1630703,1626172,1629014,1641712,1629001,1642270,203937,1630228,1630541,203924,0,3,-3,7,6,13,1300
16290011629014163070316417121642270203924203937163022816305411631218,1630703,1629014,1641712,1629001,1642270,203937,1630228,1630541,203924,1631218,6,3,3,3,3,6,830
1629001162901416302281630703164227020193920392420395216301661631218,1630703,1629014,1629001,1642270,1630228,203924,1631218,201939,203952,1630166,6,7,-1,2,3,5,780
2039241629001163022816307031631218201939203952162902816301661641739,1630703,1629001,1630228,203924,1631218,201939,203952,1630166,1629028,1641739,0,0,0,4,3,7,520
2019392039241630166163070316312182031101627741162902816417391641764,1630703,203924,1631218,201939,1630166,1629028,1641739,203110,1627741,1641764,4,7,-3,3,3,6,1050
2019392039241629028163016616312182031101627741162901416417391641764,203924,1631218,201939,1630166,1629028,1641739,203110,1627741,1641764,1629014,5,8,-3,4,4,8,1080
201939203924162902816301661641739203110203952162774116290141641764,203924,201939,1630166,1629028,1641739,203110,1627741,1641764,1629014,203952,3,2,1,1,1,2,240
201939203924162902816301661641739203110203952162778016290141641764,203924,201939,1630166,1629028,1641739,203110,1641764,1629014,203952,1627780,5,11,-6,4,5,9,1300
2031102039241629028163016616417642039521626172162778016290141630703,203924,1630166,1629028,203110,1641764,1629014,203952,1627780,1626172,1630703,0,0,0,0,0,0,37
203110203924162902816301661641764201939203952162778016290141630703,203924,1630166,1629028,203110,1641764,1629014,203952,1627780,1630703,201939,0,0,0,0,1,1,63
203110203924162901416290281630166201939203952163022816312181641739,203924,1630166,1629028,203110,1629014,203952,201939,1630228,1631218,1641739,13,18,-5,15,14,29,3540
203110203924203952162901416290282019391627741162778016307031641739,203924,1629028,203110,1629014,203952,201939,1641739,1627741,1627780,1630703,0,3,-3,2,2,4,690
20193920392416290141629028164173916261721627741162778016307031641764,203924,1629028,1629014,201939,1641739,1627741,1627780,1630703,1626172,1641764,0,6,-6,2,3,5,570
1626172162774116277801629014163070316290011631200164171216417641642270,1629014,1627741,1627780,1630703,1626172,1641764,1629001,1631200,1641712,1642270,0,0,0,1,1,2,280
1626172162774116277801630703164176416290011630625163120016417121642270,1627741,1627780,1630703,1626172,1641764,1629001,1631200,1641712,1642270,1630625,2,0,2,2,1,3,460
162617216277411629001163070316417642039371630625163120016417121642270,1627741,1630703,1626172,1641764,1629001,1631200,1641712,1642270,1630625,203937,2,3,-1,1,2,3,460
162617216290011630703163120016417642039371630541163062516417121642270,1630703,1626172,1641764,1629001,1631200,1641712,1642270,1630625,203937,1630541,0,4,-4,2,1,3,210
162617216290011630703164171216417642039371630541163062516311331642270,1630703,1626172,1641764,1629001,1641712,1642270,1630625,203937,1630541,1631133,5,4,1,4,3,7,990
20393716261721629001163054116417642039241629014162902816301661641739,1626172,1641764,1629001,203937,1630541,203924,1629014,1629028,1630166,1641739,6,2,4,3,3,6,1200
20392420393716290011630541164176416290141629028163016616312181641739,1641764,1629001,203937,1630541,203924,1629014,1629028,1630166,1641739,1631218,2,4,-2,1,2,3,520
2039242039371629001162901416305412039521629028163016616312181641739,1629001,203937,1630541,203924,1629014,1629028,1630166,1641739,1631218,203952,3,4,-1,4,4,8,1040
2039242039371629001162901416290282039521630228163070316312181641739,1629001,203937,203924,1629014,1629028,1641739,1631218,203952,1630228,1630703,4,2,2,4,3,7,880
20393720395216302281631218164173916307031631200164171216417641642270,203937,1641739,1631218,203952,1630228,1630703,1641764,1631200,1641712,1642270,0,3,-3,0,1,1,180
20393720395216302281630703163121816311331631200164171216417641642270,203937,1631218,203952,1630228,1630703,1641764,1631200,1641712,1642270,1631133,0,0,0,1,1,2,310
1630228163070316312001631218164176416303221630611163113316417121642270,1631218,1630228,1630703,1641764,1631200,1641712,1642270,1631133,1630322,1630611,2,2,0,1,0,1,230
1630703163120016417121641764164227016277801630322163054116306111631133,1630703,1641764,1631200,1641712,1642270,1631133,1630322,1630611,1627780,1630541,0,0,0,0,1,1,160
1630703163113316312001641712164176416277801630322163054116306111630625,1630703,1641764,1631200,1641712,1631133,1630322,1630611,1627780,1630541,1630625,2,7,-5,3,2,5,720
1630322163070316311331641712164176416277801630541163061116306251641871,1630703,1641764,1641712,1631133,1630322,1630611,1627780,1630541,1630625,1641871,13,16,-3,8,9,17,1960
1627832162841516289701628998163016316302081630224163057816310951641706,1628970,1628998,1630163,1630208,1641706,1627832,1628415,1630224,1630578,1631095,7,6,1,9,8,17,2410
1627832162897016289981630163164170616284151630224163057816310951631217,1628970,1628998,1630163,1641706,1627832,1628415,1630224,1630578,1631095,1631217,3,6,-3,3,4,7,930
162783216284151628970163022416417062039951630544163057816310951631217,1628970,1641706,1627832,1628415,1630224,1630578,1631095,1631217,203995,1630544,6,0,6,4,3,7,1080
162783216284151630578163121716417062039951629684163054416417081642263,1641706,1627832,1628415,1630578,1631217,203995,1630544,1629684,1641708,1642263,2,0,2,2,2,4,620
203995162783216305441631217164170616291111629684163110616417081642263,1641706,1627832,1631217,203995,1630544,1629684,1641708,1642263,1629111,1631106,0,2,-2,1,2,3,480
162968416305441631217164170816422632035521629111163016316302241631106,1631217,1630544,1629684,1641708,1642263,1629111,1631106,203552,1630163,1630224,8,7,1,6,6,12,1667
162911116296841630544163121716417082035521628415163016316302241631106,1631217,1630544,1629684,1641708,1629111,1631106,203552,1630163,1630224,1628415,0,0,0,0,1,1,13
203552162911116296841631106164170816289981630163163020816417151642263,1629684,1641708,1629111,1631106,203552,1630163,1628998,1630208,1641715,1642263,7,6,1,5,4,9,1690
203552162968416301631631106164170816289981630208163057816417151642263,1629684,1641708,1631106,203552,1630163,1628998,1630208,1641715,1642263,1630578,5,4,1,1,2,3,500
203552162899816296841630163164170816278321630208163057816417151642263,1629684,1641708,203552,1630163,1628998,1630208,1641715,1642263,1630578,1627832,0,0,0,2,1,3,350
1628998163016316302081641715164226316278321628415162897016305441630578,1630163,1628998,1630208,1641715,1642263,1630578,1627832,1628970,1630544,1628415,4,0,4,1,2,3,220
162783216289701630208163057816417152039951628415163054416310951641706,1630208,1641715,1630578,1627832,1628970,1630544,1628415,203995,1641706,1631095,4,2,2,4,3,7,920
162783216289701630208163057816417152035521628415163016316305441631095,1630208,1641715,1630578,1627832,1628970,1630544,1628415,1631095,203552,1630163,2,0,2,1,1,2,290
162783216284151628970163054416305782035521629684163016316302241631095,1630578,1627832,1628970,1630544,1628415,1631095,203552,1630163,1629684,1630224,10,7,3,5,6,11,1840
162783216289701630544163057816310952035521629684163016316302241641708,1630578,1627832,1628970,1630544,1631095,203552,1630163,1629684,1630224,1641708,0,2,-2,0,0,0,20
1627832162897016305441630578163109516289981629684163016316302241641708,1630578,1627832,1628970,1630544,1631095,1630163,1629684,1630224,1641708,1628998,0,0,0,1,0,1,130
1627832162897016305441630578163109516289981630163163020816302241641708,1630578,1627832,1628970,1630544,1631095,1630163,1630224,1641708,1628998,1630208,2,7,-5,4,5,9,1240
162783216289701630163163057816310952035521628415162899816302081630224,1630578,1627832,1628970,1631095,1630163,1630224,1628998,1630208,203552,1628415,15,12,3,10,9,19,3000
16278321628970163022416305781631095203552203995162841516289981631217,1630578,1627832,1628970,1631095,1630224,1628998,203552,1628415,203995,1631217,0,3,-3,2,3,5,830
20355216278321628415163057816310952039951629684163054416312171641708,1630578,1627832,1631095,203552,1628415,203995,1631217,1629684,1630544,1641708,0,0,0,1,1,2,340
20355220399516278321630578163109516296841630544163121716417081642263,1630578,1627832,1631095,203552,203995,1631217,1629684,1630544,1641708,1642263,2,3,-1,2,1,3,530
203995162783216296841630544163121716291111630163163110616417081642263,1627832,203995,1631217,1629684,1630544,1641708,1642263,1630163,1629111,1631106,0,4,-4,3,3,6,770
203995162968416305441631217164170816291111630163163022416311061642263,203995,1631217,1629684,1630544,1641708,1642263,1630163,1629111,1631106,1630224,6,6,0,3,4,7,1389
1629684163054416312171641708164226316289981629111163016316302241631106,1631217,1629684,1630544,1641708,1642263,1630163,1629111,1631106,1630224,1628998,0,2,-2,2,2,4,263
1629684163016316305441631217164170816278321628998163022416305781631106,1631217,1629684,1630544,1641708,1630163,1631106,1630224,1628998,1627832,1630578,0,0,0,2,1,3,78
163016316302241630544163057816311062035521628970163020816417151642263,1630544,1630163,1631106,1630224,1630578,203552,1628970,1630208,1641715,1642263,0,6,-6,3,3,6,840
203552163016316302241630544163057816278321628415162897016302081631095,1630544,1630163,1630224,1630578,203552,1628970,1630208,1627832,1628415,1631095,0,0,0,0,1,1,470
20355216289701630224163054416305782039951627832162841516302081631095,1630544,1630224,1630578,203552,1628970,1630208,1627832,1628415,1631095,203995,3,0,3,2,1,3,500
162783216289701630224163054416305782039951628415162899816296841631095,1630544,1630224,1630578,1628970,1627832,1628415,1631095,203995,1628998,1629684,2,0,2,2,3,5,750
162783216284151628970163022416305782039951628998162968416301631631095,1630224,1630578,1628970,1627832,1628415,1631095,203995,1628998,1629684,1630163,2,6,-4,3,2,5,900
162783216284151628970163057816310952039951628998162968416301631641708,1630578,1628970,1627832,1628415,1631095,203995,1628998,1629684,1630163,1641708,3,2,1,2,3,5,820
162783216284151629684163016316310952035521630208163022416305441641708,1627832,1628415,1631095,1629684,1630163,1641708,203552,1630208,1630544,1630224,3,0,3,2,2,4,740
162783216284151630163163109516417082035521628970163020816302241630544,1627832,1628415,1631095,1630163,1641708,203552,1630208,1630544,1630224,1628970,2,10,-8,4,3,7,1180
203552162783216284151630163163109516289701629684163022416305441630578,1627832,1628415,1631095,1630163,203552,1630544,1630224,1628970,1629684,1630578,7,3,4,3,3,6,687
203552162783216284151630163163109516289701629684163022416305441641708,1627832,1628415,1631095,1630163,203552,1630544,1630224,1628970,1629684,1641708,0,2,-2,0,0,0,265
162783216284151628970163016316302242035521629684163054416311061641708,1627832,1628415,1630163,1630224,1628970,1629684,203552,1630544,1631106,1641708,0,2,-2,0,1,1,11
162783216284151628970163016316302242035521629684163054416305781631106,1627832,1628415,1630163,1630224,1628970,1629684,203552,1630544,1631106,1630578,0,0,0,1,0,1,37
16261672026992035011627783162961416301691630174163059516310931631105,1626167,1627783,1629614,1630169,1630174,202699,203501,1630595,1631093,1631105,12,7,5,11,11,22,3090
16261671627783162961416301691630174202699203501162773616305951631105,1626167,1627783,1629614,1630169,1630174,202699,203501,1630595,1631105,1627736,0,5,-5,3,2,5,670
20269916277831629614163016916301742035011627736163016416301911630595,1627783,1629614,1630169,1630174,202699,203501,1630595,1627736,1630164,1630191,2,0,2,0,0,0,160
202699162778316296141630169163017416277361630164163019116305951631323,1627783,1629614,1630169,1630174,202699,1630595,1627736,1630164,1630191,1631323,0,5,-5,1,2,3,290
20269916277831630169163017416305952044561627736163016416301911631323,1627783,1630169,1630174,202699,1630595,1627736,1630164,1630191,1631323,204456,4,4,0,4,3,7,840
162773616301641630169163019116313232044561630167163109716312041641842,1630169,1627736,1630164,1630191,1631323,204456,1630167,1631097,1631204,1641842,4,2,2,3,4,7,890
204456162773616301641630191163132316301671631097163120416417161641842,1627736,1630164,1630191,1631323,204456,1630167,1631097,1631204,1641842,1641716,7,2,5,3,2,5,600
204456162773616301671630191163132316261671631097163120416417161641842,1627736,1630191,1631323,204456,1630167,1631097,1631204,1641842,1641716,1626167,2,0,2,3,3,6,375
20445616277361630167163109716313232026991626167163059516417161641842,1627736,1631323,204456,1630167,1631097,1641842,1641716,1626167,202699,1630595,0,0,0,0,1,1,240
20445616277361630167163109716418422026991626167163019116305951641716,1627736,204456,1630167,1631097,1641842,1641716,1626167,202699,1630595,1630191,0,0,0,0,1,1,45
204456162773616301671631097164184216261671630191163109316313231641716,1627736,204456,1630167,1631097,1641842,1641716,1626167,1630191,1631093,1631323,0,3,-3,2,1,3,520
204456162773616301671631097164184216261671631093163110516313231641716,1627736,204456,1630167,1631097,1641842,1641716,1626167,1631093,1631323,1631105,2,0,2,0,1,1,390
20445616277361630167163109716418422026991626167163109316311051641716,1627736,204456,1630167,1631097,1641842,1641716,1626167,1631093,1631105,202699,6,9,-3,5,4,9,1240
2044561627736163016716310971641716202699203501162616716310931631105,1627736,204456,1630167,1631097,1641716,1626167,1631093,1631105,202699,203501,2,0,2,1,2,3,220
16301671631093163109716311051641716202699203501163016916305951642402,1630167,1631097,1641716,1631093,1631105,202699,203501,1630169,1642402,1630595,0,0,0,1,0,1,180
20269920350116301671631093163110516296141630169163017416305951642402,1630167,1631093,1631105,202699,203501,1630169,1642402,1630595,1629614,1630174,2,0,2,2,2,4,420
20269920350116301691631093163110516277831629614163017416305951642402,1631093,1631105,202699,203501,1630169,1642402,1630595,1629614,1630174,1627783,0,0,0,0,1,1,320
20269920350116301691631105164240216277361627783162961416301741630595,1631105,202699,203501,1630169,1642402,1630595,1629614,1630174,1627783,1627736,0,2,-2,2,1,3,470
20269920350116301691630595164240216277361627783162961416301741630191,202699,203501,1630169,1642402,1630595,1629614,1630174,1627783,1627736,1630191,3,2,1,2,2,4,680
20269920350116296141630169163059516261671627736162778316301741630191,202699,203501,1630169,1630595,1629614,1630174,1627783,1627736,1630191,1626167,4,2,2,2,3,5,890
20269920350116296141630169163059516261671627736162778316301741631105,202699,203501,1630169,1630595,1629614,1630174,1627783,1627736,1626167,1631105,2,2,0,1,0,1,260
20269920350116296141630169163059516261671627736162778316310971631105,202699,203501,1630169,1630595,1629614,1627783,1627736,1626167,1631105,1631097,6,8,-2,9,10,19,2630
20269920350116296141630169163059516261671627783163017416310931631105,202699,203501,1630169,1630595,1629614,1627783,1626167,1631105,1630174,1631093,17,18,-1,10,9,19,2970
20269920350116296141630169163059516261671627783163109316310971631105,202699,203501,1630169,1630595,1629614,1627783,1626167,1631105,1631093,1631097,0,0,0,1,1,2,340
20269920350116296141630169163059516261671627783163019116310971641842,202699,203501,1630169,1630595,1629614,1627783,1626167,1631097,1630191,1641842,0,3,-3,0,1,1,320
1626167162778316296141630169163059516301911631093163109716313231641842,1630169,1630595,1629614,1627783,1626167,1631097,1630191,1641842,1631093,1631323,0,0,0,1,1,2,260
1629614163016916301911630595163109716301671631093163132316418421642402,1630169,1630595,1629614,1631097,1630191,1641842,1631093,1631323,1630167,1642402,0,4,-4,1,1,2,380
162961416301911630595163109716418422044561630167163109316313231642402,1630595,1629614,1631097,1630191,1641842,1631093,1631323,1630167,1642402,204456,5,0,5,2,2,4,410
162961416301911630595163109316418422044561630167163132316417671642402,1630595,1629614,1630191,1641842,1631093,1631323,1630167,1642402,204456,1641767,4,4,0,3,2,5,860
162961416301911631093163132316418422044561627736163016716417671642402,1629614,1630191,1641842,1631093,1631323,1630167,1642402,204456,1641767,1627736,3,0,3,1,1,2,262
163016716301911631093163132316418422044561626167162773616310971641767,1630191,1641842,1631093,1631323,1630167,204456,1641767,1627736,1626167,1631097,0,0,0,1,1,2,162
20445616301671631093163132316417672026991627736162961416305951631097,1631093,1631323,1630167,204456,1641767,1627736,1631097,1629614,202699,1630595,3,1,2,1,1,2,216
204456163016716310931631323164176716261671627736163109716311051641842,1631093,1631323,1630167,204456,1641767,1627736,1631097,1626167,1631105,1641842,8,14,-6,7,8,15,2210
16261671627736162778316296141631097202699203501163016916301911630595,1627736,1631097,1626167,1627783,1629614,1630169,202699,203501,1630191,1630595,2,4,-2,4,4,8,1080
16261671627783162961416301691631097202699203501163019116305951631093,1631097,1626167,1627783,1629614,1630169,202699,203501,1630191,1630595,1631093,0,0,0,3,3,6,1160
16261671627783162961416301691631097202699203501163059516310931631105,1631097,1626167,1627783,1629614,1630169,202699,203501,1630595,1631093,1631105,4,7,-3,4,3,7,1380
162616716277831629614163016916310972026991627736163059516310931631105,1631097,1626167,1627783,1629614,1630169,202699,1630595,1631093,1631105,1627736,3,5,-2,4,4,8,1166
20269916277831629614163016916310972035011627736163017416305951631093,1631097,1627783,1629614,1630169,202699,1630595,1631093,1627736,1630174,203501,2,0,2,0,1,1,123
202699162778316296141630169163109716261671630595163109316311051641842,1631097,1627783,1629614,1630169,202699,1630595,1631093,1626167,1631105,1641842,0,2,-2,0,0,0,11
202699162778316296141630595163109716277361630174163109316311051641767,1631097,1627783,1629614,202699,1630595,1631093,1631105,1630174,1641767,1627736,0,0,0,1,1,2,70
203935162837416290121629630163021716305831631117164170716417181641744,203935,1629630,1630217,1630583,1641744,1628374,1629012,1631117,1641707,1641718,12,11,1,8,8,16,2320
203935162837416290121629630164174416305901631117164170716417181642377,203935,1629630,1641744,1628374,1629012,1631117,1641707,1641718,1630590,1642377,2,3,-1,3,3,6,620
1629012163059016311171641707164171816296341630217163058316417291642377,1629012,1631117,1641707,1641718,1630590,1642377,1629634,1630217,1630583,1641729,1,3,-2,4,5,9,960
163059016311171641707164171816423772039031629634163021716305831641729,1631117,1641707,1641718,1630590,1642377,1629634,1630217,1630583,1641729,203903,1,0,1,1,0,1,220
162963416302171630590164171816423772039031628381163058316417291642262,1641718,1630590,1642377,1629634,1630217,1630583,1641729,203903,1628381,1642262,0,0,0,1,1,2,340
162963416305831630590164171816423772039031628381162972316417291642262,1641718,1630590,1642377,1629634,1630583,1641729,203903,1628381,1642262,1629723,0,6,-6,2,3,5,710
16296341630583163059016417291642377201988203903162838116297231642262,1630590,1642377,1629634,1630583,1641729,203903,1628381,1642262,1629723,201988,2,0,2,2,2,4,460
20390316283811629634163059016423772019881628374162972316312221642262,1630590,1642377,1629634,203903,1628381,1642262,1629723,201988,1631222,1628374,0,0,0,1,1,2,300
20390316283811629723163059016422622019881628374162963016306431631222,1630590,203903,1628381,1642262,1629723,201988,1631222,1628374,1629630,1630643,2,0,2,1,1,2,220
2019882039031628381162972316422622039351628374162963016306431631222,203903,1628381,1642262,1629723,201988,1631222,1628374,1629630,1630643,203935,3,6,-3,3,3,6,900
2019882039031628381162972316422622039351628374162963016296341631222,203903,1628381,1642262,1629723,201988,1631222,1628374,1629630,203935,1629634,0,0,0,2,0,2,150
2019882039031628381162972316312222039351628374162963016306431641707,203903,1628381,1629723,201988,1631222,1628374,1629630,203935,1630643,1641707,4,7,-3,4,5,9,1360
2019882039031628381162972316312222039351628374162963016417441642262,203903,1628381,1629723,201988,1631222,1628374,1629630,203935,1641744,1642262,2,0,2,2,2,4,420
2019882039031628374162838116312222039351629630163021716417441642262,203903,1628381,201988,1631222,1628374,1629630,203935,1641744,1642262,1630217,4,5,-1,3,3,6,850
2019882039031628374162838116312222039351630217163059016417441642262,203903,1628381,201988,1631222,1628374,203935,1641744,1642262,1630217,1630590,2,0,2,1,0,1,470
203935163059016306431631222164226216290121631117164171816417291642377,1631222,203935,1642262,1630590,1630643,1642377,1629012,1631117,1641718,1641729,2,2,0,3,3,6,490
1629012163059016306431642262164237716296341630583163111716417181641729,1642262,1630590,1630643,1642377,1629012,1631117,1641718,1641729,1629634,1630583,5,11,-6,6,7,13,1720
1629012163059016306431642262164237716283741630583163111716312221641718,1642262,1630590,1630643,1642377,1629012,1631117,1641718,1630583,1631222,1628374,6,5,1,4,3,7,1070
1629012163064316311171642262164237716283741629630163058316312221641718,1642262,1630643,1642377,1629012,1631117,1641718,1630583,1631222,1628374,1629630,0,2,-2,1,2,3,317
1629012163064316311171642262164237716283741629630162972316305831641718,1642262,1630643,1642377,1629012,1631117,1641718,1630583,1628374,1629630,1629723,2,0,2,2,1,3,458
1629012163064316311171642262164237716283741629630163021716305831641718,1642262,1630643,1642377,1629012,1631117,1641718,1630583,1628374,1629630,1630217,0,0,0,1,1,2,45
162837416290121630583163111716417182039351629630163021716417071641744,1629012,1631117,1641718,1630583,1628374,1629630,1630217,203935,1641744,1641707,16,10,6,7,8,15,2510
162837416290121630583163111716417182039351629630163021716306431641707,1629012,1631117,1641718,1630583,1628374,1629630,1630217,203935,1641707,1630643,4,6,-2,3,2,5,840
1629012163021716305831631117164171816305901630643164170716417291642377,1629012,1631117,1641718,1630583,1630217,1641707,1630643,1630590,1642377,1641729,0,0,0,2,2,4,370
163021716305831630643164170716417182039031628381163059016417291642377,1641718,1630583,1630217,1641707,1630643,1630590,1642377,1641729,203903,1628381,0,0,0,0,0,0,130
163021716305831630590164170716417182039031628381162963416417291642377,1641718,1630583,1630217,1641707,1630590,1642377,1641729,203903,1628381,1629634,9,10,-1,7,7,14,1990
20390316283811629630162963416423772019881628374162972316312221642262,1642377,203903,1628381,1629634,1629630,1629723,1631222,201988,1628374,1642262,5,3,2,2,3,5,1150
20390316283811629630162963416423772019881628374162972316305901642262,1642377,203903,1628381,1629634,1629630,1629723,201988,1628374,1642262,1630590,2,3,-1,2,3,5,210
2019882039031628381162963016297232039351628374163122216417441642262,203903,1628381,1629630,1629723,201988,1628374,1642262,203935,1631222,1641744,2,3,-1,2,1,3,420
2019882039031628381162963016297232039351628374163122216417071641744,203903,1628381,1629630,1629723,201988,1628374,203935,1631222,1641744,1641707,3,6,-3,3,4,7,910
2019882039031628374162963016297232039351631117163122216417071641744,203903,1629630,1629723,201988,1628374,203935,1631222,1641744,1641707,1631117,0,0,0,1,0,1,320
2019882039031628374162963016297232039351630643163111716312221641707,203903,1629630,1629723,201988,1628374,203935,1631222,1641707,1631117,1630643,5,0,5,1,2,3,340
20198820390316283741629723164170716302171630590163064316311171642377,203903,1629723,201988,1628374,1641707,1631117,1630643,1630217,1630590,1642377,8,2,6,3,2,5,810
20198820390316283741631117164170716302171630583163059016306431642377,203903,201988,1628374,1641707,1631117,1630643,1630217,1630590,1642377,1630583,1,0,1,1,1,2,350
203903163021716306431631117164170716290121630583163059016417181642377,203903,1641707,1631117,1630643,1630217,1630590,1642377,1630583,1629012,1641718,0,6,-6,3,3,6,670
1630217163059016306431631117164237716283741629012163058316417181642262,1631117,1630643,1630217,1630590,1642377,1630583,1629012,1641718,1628374,1642262,4,4,0,2,3,5,680
163021716305831630590163064316311172039351628374162901216417181642262,1631117,1630643,1630217,1630590,1630583,1629012,1641718,1628374,1642262,203935,3,0,3,2,1,3,300
162901216302171630583163064316311172039351628374162963016417071641718,1631117,1630643,1630217,1630583,1629012,1641718,1628374,203935,1629630,1641707,5,4,1,3,3,6,1040
16290121630217163058316306431631117203903203935162837416296301641707,1631117,1630643,1630217,1630583,1629012,1628374,203935,1629630,1641707,203903,1,2,-1,2,3,5,520
16283741630217163058316306431631117203903203935162963016417071641718,1631117,1630643,1630217,1630583,1628374,203935,1629630,1641707,203903,1641718,3,6,-3,2,2,4,780
20393516283741630217163058316306432039031629012162963016417071641718,1630643,1630217,1630583,1628374,203935,1629630,1641707,203903,1641718,1629012,3,0,3,1,1,2,60
201142203078201935203994162614516261641626181162782616278841629611,201142,203078,203994,1626145,1626164,201935,1626181,1627826,1627884,1629611,5,3,2,4,4,8,1550
201142203078203994162614516261642019351626181162788416296111630539,201142,203078,203994,1626145,1626164,201935,1626181,1627884,1629611,1630539,4,4,0,2,1,3,380
201142201935203078162614516261642034861626181162788416296111630539,201142,203078,1626145,1626164,201935,1626181,1627884,1629611,1630539,203486,2,3,-1,3,3,6,720
2011422019351626145162616416261812034861626220162788416296111630539,201142,1626145,1626164,201935,1626181,1627884,1629611,1630539,203486,1626220,7,8,-1,4,5,9,1350
201142201935162616416261811629611201587203486162622016284201630539,201142,1626164,201935,1626181,1629611,1630539,203486,1626220,1628420,201587,2,0,2,3,2,5,890
2019352034861626164162961116305392015871626220162842016296451642346,1626164,201935,1629611,1630539,203486,1626220,1628420,201587,1642346,1629645,0,0,0,1,1,2,310
20348616262201628420162961116305392015871627739162964516423451642346,1629611,1630539,203486,1626220,1628420,201587,1642346,1629645,1642345,1627739,0,0,0,0,1,1,170
20158716262201628420163053916423462030781627739162959916296451642345,1630539,1626220,1628420,201587,1642346,1629645,1642345,1627739,203078,1629599,2,0,2,1,0,1,300
20158716284201629645163053916423462030781627739162896016295991642345,1630539,1628420,201587,1642346,1629645,1642345,1627739,203078,1629599,1628960,0,5,-5,5,6,11,1530
201587203078162773916296451642345201142203994162782616289601629599,201587,1629645,1642345,1627739,203078,1629599,1628960,201142,203994,1627826,5,6,-1,5,4,9,1270
2015872030781627739162964516423452011421626220162782616289601629599,201587,1629645,1642345,1627739,203078,1629599,1628960,201142,1627826,1626220,0,0,0,0,0,0,330
201587203078162773916295991642345201142201935162622016278261628960,201587,1642345,1627739,203078,1629599,1628960,201142,1627826,1626220,201935,0,2,-2,2,2,4,390
201142203078162773916278261629599201935203994162614516261811626220,1627739,203078,1629599,201142,1627826,1626220,201935,203994,1626145,1626181,0,3,-3,3,3,6,770
2011422019351626220162782616295992039941626145162616416261811627884,1629599,201142,1627826,1626220,201935,203994,1626145,1626181,1626164,1627884,0,0,0,1,1,2,210
2011422019352039941626220162782616261451626164162618116278841629611,201142,1627826,1626220,201935,203994,1626145,1626181,1626164,1627884,1629611,0,6,-6,3,3,6,1110
2011422019351626145162622016278262034861626164162618116278841629611,201142,1627826,1626220,201935,1626145,1626181,1626164,1627884,1629611,203486,2,0,2,3,4,7,660
20193516261451626181162622016278262034861626164162788416289601629611,1627826,1626220,201935,1626145,1626181,1626164,1627884,1629611,203486,1628960,2,5,-3,3,3,6,940
201935162616416261811627884162961120158720307820348616289601642346,201935,1626181,1626164,1627884,1629611,203486,1628960,203078,1642346,201587,1,0,1,1,0,1,160
201935162616416261811627884162961120114220158720307816289601642346,201935,1626181,1626164,1627884,1629611,1628960,203078,1642346,201587,201142,3,0,3,1,2,3,360
201935162616416261811628960162961120114220158720307816277391642346,201935,1626181,1626164,1629611,1628960,203078,1642346,201587,201142,1627739,2,0,2,1,0,1,220
201935162616416261811628960162961120114220158720307816261451627739,201935,1626181,1626164,1629611,1628960,203078,201587,201142,1627739,1626145,0,0,0,0,1,1,252
2030781626164162618116289601629611201142201587162614516277391629645,1626181,1626164,1629611,1628960,203078,201587,201142,1627739,1626145,1629645,0,1,-1,0,0,0,35
2015872030781626164162618116289602011421627739162959916296451642345,1626181,1626164,1628960,203078,201587,201142,1627739,1629645,1642345,1629599,2,1,1,2,2,4,493
201142203078203994162616416261812019351626145162782616278841629611,1626181,1626164,203078,201142,203994,1626145,201935,1627826,1627884,1629611,9,4,5,7,7,14,1890
20114220307820399416261641626181201587201935162614516278261627884,1626181,1626164,203078,201142,203994,1626145,201935,1627826,1627884,201587,1,0,1,1,0,1,320
201142203078162614516261641626181201587201935162782616278841642345,1626181,1626164,203078,201142,1626145,201935,1627826,1627884,201587,1642345,3,2,1,2,2,4,690
2011422019351626145162616416261812015871626220162782616278841642345,1626181,1626164,201142,1626145,201935,1627826,1627884,201587,1642345,1626220,8,2,6,5,6,11,1170
2011422019351626164162618116278262015871626220162788416284201642345,1626181,1626164,201142,201935,1627826,1627884,201587,1642345,1626220,1628420,2,4,-2,5,4,9,940
2015872019351626181162782616423452030781626220162773916284201642346,1626181,201935,1627826,201587,1642345,1626220,1628420,203078,1642346,1627739,2,0,2,0,0,0,40
2015872019351626181162622016423452030781627739162842016305391642346,1626181,201935,201587,1642345,1626220,1628420,203078,1642346,1627739,1630539,0,1,-1,0,1,1,20
201587201935203078162842016423462034861627739162896016296451630539,201935,201587,1628420,203078,1642346,1627739,1630539,203486,1628960,1629645,10,12,-2,9,8,17,2130
201587203078203486162773916284202011421627826162896016295991629645,201587,1628420,203078,1627739,203486,1628960,1629645,201142,1627826,1629599,0,0,0,0,1,1,280
2030782034861627739162842016289602011421627826162959916296111629645,1628420,203078,1627739,203486,1628960,1629645,201142,1627826,1629599,1629611,4,2,2,3,3,6,920
2011422030781627739162782616289602039941626145162618116295991629611,203078,1627739,1628960,201142,1627826,1629599,1629611,203994,1626145,1626181,4,1,3,2,2,4,500
2011422030781627739162782616295992039941626145162616416261811629611,203078,1627739,201142,1627826,1629599,1629611,203994,1626145,1626181,1626164,6,4,2,5,5,10,1090
20114216277391627826162959916296112039941626145162616416261811626220,1627739,201142,1627826,1629599,1629611,203994,1626145,1626181,1626164,1626220,3,5,-2,3,2,5,970
201142203994162782616295991629611201935203078162614516261641626181,201142,1627826,1629599,1629611,203994,1626145,1626181,1626164,203078,201935,7,6,1,4,4,8,1120
2011421626145162782616295991629611201935203078162616416261811626220,201142,1627826,1629599,1629611,1626145,1626181,1626164,203078,201935,1626220,1,5,-4,2,2,4,370
2011421626145162618116295991629611201935203078162616416262201627884,201142,1629599,1629611,1626145,1626181,1626164,203078,201935,1626220,1627884,0,0,0,0,1,1,290
2011421626145162616416261811629599201935203078162622016278261627884,201142,1629599,1626145,1626181,1626164,203078,201935,1626220,1627884,1627826,0,3,-3,4,3,7,650
201142162614516261641626181162959920158720193520307816262201627884,201142,1629599,1626145,1626181,1626164,203078,201935,1626220,1627884,201587,0,3,-3,0,0,0,140
2011422030781626145162618116295992019351626220162782616278841628960,201142,1629599,1626145,1626181,203078,201935,1626220,1627884,1627826,1628960,2,0,2,1,1,2,455
201142201935203078162614516295992015871626220162773916278841628960,201142,1629599,1626145,203078,201935,1626220,1627884,1628960,201587,1627739,12,15,-3,12,13,25,415
201142201935203078162614516295992039941626181162782616278841628960,201142,1629599,1626145,203078,201935,1627884,1628960,203994,1626181,1627826,0,0,0,0,0,0,1360
201142201935203078162614516295992039941626181162622016278261627884,201142,1629599,1626145,203078,201935,1627884,203994,1626181,1627826,1626220,0,0,0,0,0,0,290
20114220193520307816261451629599201587203994162618116262201627884,201142,1629599,1626145,203078,201935,1627884,203994,1626181,1626220,201587,0,0,0,0,0,0,568
201142201935203078162614516295992015871626181162622016278841628960,201142,1629599,1626145,203078,201935,1627884,1626181,1626220,201587,1628960,0,0,0,0,0,0,752
2011422019352030781626145162959916261811626220162773916278841628960,201142,1629599,1626145,203078,201935,1627884,1626220,1628960,1626181,1627739,0,0,0,0,0,0,30
20348420271016261791628389162897616296391630532163059116310941631107,203484,1628976,1630532,1630591,1631094,202710,1626179,1628389,1629639,1631107,12,11,1,11,10,21,3150
2027102034841626179162897616310942039141628389162963916311071641710,203484,1628976,1631094,202710,1626179,1628389,1629639,1631107,203914,1641710,7,0,7,3,4,7,630
20271016283891628976162963916310942039141630175163110716311701641710,1628976,1631094,202710,1628389,1629639,1631107,203914,1641710,1630175,1631170,2,8,-6,3,3,6,890
20271020391416289761629639163109416284181629312163017516311701641710,1628976,1631094,202710,1629639,203914,1641710,1630175,1631170,1628418,1629312,3,5,-2,3,2,5,660
203914163017516310941631170164171016261791628418162902116291301629312,1631094,203914,1641710,1630175,1631170,1628418,1629312,1629021,1626179,1629130,4,5,-1,3,3,6,710
203914162841816301751631170164171016261791628371162902116291301629312,203914,1641710,1630175,1631170,1628418,1629312,1629021,1626179,1629130,1628371,4,3,1,3,3,6,1028
20391416290211629312163117016417102034841626179162837116291301629639,203914,1641710,1631170,1629312,1629021,1626179,1629130,1628371,203484,1629639,0,0,0,1,2,3,132
203914162902116293121631170164171016261791628371162841816291301630175,203914,1641710,1631170,1629312,1629021,1626179,1629130,1628371,1630175,1628418,2,3,-1,4,4,8,1170
203914162617916290211629312164171016283711628418162913016296391630175,203914,1641710,1629312,1629021,1626179,1629130,1628371,1630175,1628418,1629639,3,0,3,2,1,3,460
1626179162902116291301629312164171016283711628418162963916301751630532,1641710,1629312,1629021,1626179,1629130,1628371,1630175,1628418,1629639,1630532,5,3,2,1,2,3,510
162617916290211629130162931216417102034841628371162841816296391630532,1641710,1629312,1629021,1626179,1629130,1628371,1628418,1629639,1630532,203484,0,0,0,1,0,1,180
162617916291301629312162963916417102034841628389162897616305321631094,1641710,1629312,1626179,1629130,1629639,1630532,203484,1628976,1631094,1628389,0,2,-2,1,2,3,480
16291301629312162963916305321641710202710203484162838916289761631094,1641710,1629312,1629130,1629639,1630532,203484,1628976,1631094,1628389,202710,5,4,1,4,4,8,910
2034841628976162913016296391630532202710203914162838916310941631107,1629130,1629639,1630532,203484,1628976,1631094,1628389,202710,203914,1631107,4,5,-1,5,4,9,1330
2034841628389162897616296391631094202710203914162617916311071641710,1629639,203484,1628976,1631094,1628389,202710,203914,1631107,1641710,1626179,3,6,-3,6,7,13,2039
2034841628389162897616296391631094202710203914162617916293121641710,1629639,203484,1628976,1631094,1628389,202710,203914,1641710,1626179,1629312,0,3,-3,1,1,2,121
20348416283891628976162963916310942027101626179163053216305911631107,1629639,203484,1628976,1631094,1628389,202710,1626179,1630532,1630591,1631107,5,16,-11,9,9,18,2620
20348416283891628976162963916310942027101626179162931216305321630591,1629639,203484,1628976,1631094,1628389,202710,1626179,1630532,1630591,1629312,3,6,-3,4,4,8,1110
20348416283891628976162963916310942027101629312163053216305911631170,1629639,203484,1628976,1631094,1628389,202710,1630532,1630591,1629312,1631170,0,5,-5,3,2,5,640
2034841628389162897616296391631094202710203914162931216311701641710,1629639,203484,1628976,1631094,1628389,202710,1629312,1631170,203914,1641710,2,7,-5,3,3,6,1390
20348420391416293121631170164171016261791628371162841816290211629130,203484,1629312,1631170,203914,1641710,1628371,1629021,1626179,1628418,1629130,0,0,0,1,1,2,360
203914162837116293121631170164171016261791628418162902116291301630175,1629312,1631170,203914,1641710,1628371,1629021,1626179,1628418,1629130,1630175,16,7,9,7,6,13,2140
1628371162902116293121631170164171016261791628418162913016301751630532,1629312,1631170,1641710,1628371,1629021,1626179,1628418,1629130,1630175,1630532,0,4,-4,3,4,7,890
1626179162902116293121631170164171016284181629130163017516305321631094,1629312,1631170,1641710,1629021,1626179,1628418,1629130,1630175,1630532,1631094,4,13,-9,6,5,11,1500
1629021162931216301751630532164171016306961631094163110716417961642276,1629312,1641710,1629021,1630175,1630532,1631094,1630696,1631107,1641796,1642276,0,0,0,1,1,2,540
162931216306961631107164179616422762027091629048163121616417241641783,1629312,1630696,1631107,1641796,1642276,202709,1629048,1631216,1641724,1641783,13,0,13,10,11,21,3210
20157220308120156920308320350716261621627752162901816301781630231,201572,203081,203507,1627752,1629018,201569,203083,1626162,1630178,1630231,8,4,4,9,9,18,2610
20157220308120350716277521629018201569203083162616216289971630178,201572,203081,203507,1627752,1629018,201569,203083,1626162,1630178,1628997,2,6,-4,4,3,7,870
201569201572203081162775216290182030831626171162782416289971630178,201572,203081,1627752,1629018,201569,203083,1630178,1628997,1626171,1627824,5,2,3,4,4,8,1460
2015722030811628997162901816301782007681626162162617116261921627824,201572,203081,1629018,1630178,1628997,1626171,1627824,1626192,200768,1626162,2,2,0,2,2,4,570
2030811626171162899716290181630178200768203507162616216261921627824,203081,1629018,1630178,1628997,1626171,1627824,1626192,200768,1626162,203507,0,5,-5,2,3,5,850
1626171162619216278241628997162901820076820156920350716261531626162,1629018,1628997,1626171,1627824,1626192,200768,1626162,203507,1626153,201569,2,0,2,1,1,2,367
2007681626171162619216278241628997201569203507162615316261621631260,1628997,1626171,1627824,1626192,200768,1626162,203507,1626153,201569,1631260,2,3,-1,2,1,3,417
20076816261621626171162619216278242015691626153162775216301781631260,1626171,1627824,1626192,200768,1626162,1626153,201569,1631260,1627752,1630178,2,0,2,0,2,2,56
20076816261621626171162619216278242035071626153162899716302311631260,1626171,1627824,1626192,200768,1626162,1626153,1631260,203507,1628997,1630231,4,9,-5,6,5,11,1970
2035071626153162617116261921628997201569203083162901816301781630231,1626171,1626192,1626153,203507,1628997,1630231,1629018,201569,203083,1630178,4,0,4,1,2,3,580
162617116261921628997162901816302312015692015722030812030831630178,1626171,1626192,1628997,1630231,1629018,201569,203083,1630178,201572,203081,4,5,-1,6,5,11,1190
201569203083162617116290181630231201572203081162616216277521630178,1626171,1630231,1629018,201569,203083,1630178,201572,203081,1627752,1626162,2,9,-7,4,4,8,1130
201572203083162617116290181630178200768203081162775216278241628997,1626171,1629018,203083,1630178,201572,203081,1627752,200768,1627824,1628997,5,9,-4,3,4,7,1060
20157220308120308316290181630178200768203507162775216278241628997,1629018,203083,1630178,201572,203081,1627752,200768,1627824,1628997,203507,2,1,1,3,3,6,610
201572203081162775216290181630178200768203507162782416289971630231,1629018,1630178,201572,203081,1627752,200768,1627824,1628997,203507,1630231,0,1,-1,0,0,0,82
20157220308116277521629018163017820076820156920350716278241628997,1629018,1630178,201572,203081,1627752,200768,1627824,1628997,203507,201569,3,2,1,3,4,7,578
20157220308116277521629018163017820156920308320350716261621628997,1629018,1630178,201572,203081,1627752,1628997,203507,201569,203083,1626162,14,14,0,9,9,18,2640
2015722030811627752162901816301782035071626162162782416289971630231,1629018,1630178,201572,203081,1627752,1628997,203507,1626162,1627824,1630231,3,10,-7,6,5,11,1410
20157220308116277521629018163017816261621626171162782416289971630231,1629018,1630178,201572,203081,1627752,1628997,1626162,1627824,1630231,1626171,1,0,1,0,0,0,70
2015722030811627752162901816301782007681626162162617116278241641741,1629018,1630178,201572,203081,1627752,1626162,1627824,1626171,200768,1641741,3,0,3,1,2,3,210
2015722030811627824162901816301782007681626171162619216289971641741,1629018,1630178,201572,203081,1627824,1626171,200768,1641741,1626192,1628997,1,0,1,1,0,1,140
2015722030811626171162782416301782007681626153162619216289971641741,1630178,201572,203081,1627824,1626171,200768,1641741,1626192,1628997,1626153,7,12,-5,7,7,14,1670
20076820157220308116261921641741203083203507162615316261621628997,201572,203081,200768,1641741,1626192,1628997,1626153,203507,203083,1626162,5,6,-1,3,3,6,1060
200768203507162615316261921628997201569203083162617116277521630178,200768,1626192,1628997,1626153,203507,203083,1626171,1627752,201569,1630178,3,2,1,2,2,4,830
2007682035071626153162619216289972015691626171162775216278241630178,200768,1626192,1628997,1626153,203507,1626171,1627752,201569,1630178,1627824,2,0,2,1,2,3,760
20076820350716261531626192162899716261621626171162775216278241630178,200768,1626192,1628997,1626153,203507,1626171,1627752,1630178,1627824,1626162,2,3,-1,1,1,2,180
2007682035071626171162619216289972030811626162162775216278241630178,200768,1626192,1628997,203507,1626171,1627752,1630178,1627824,1626162,203081,4,0,4,4,4,8,810
2007681626171162619216289971630178201572203081162616216278241629018,200768,1626192,1628997,1626171,1630178,1627824,1626162,203081,201572,1629018,3,5,-2,3,3,6,1090
2007681626171162782416289971630178201572203081162616216277521629018,200768,1628997,1626171,1630178,1627824,1626162,203081,201572,1629018,1627752,0,0,0,1,0,1,100
200768162616216278241628997163017820157220308120350716277521629018,200768,1628997,1630178,1627824,1626162,203081,201572,1629018,1627752,203507,2,3,-1,2,3,5,850
20076820308116261621628997163017820157220308320350716277521629018,200768,1628997,1630178,1626162,203081,201572,1629018,1627752,203507,203083,0,2,-2,1,1,2,260
201572203081162616216290181630178203083203507162775216417411642272,1630178,1626162,203081,201572,1629018,1627752,203507,203083,1641741,1642272,2,2,0,2,2,4,730
2015722030812035071627752162901816302881631311164173716417411642272,203081,201572,1629018,1627752,203507,1641741,1642272,1630288,1631311,1641737,2,0,2,2,1,3,260
20157220308116277521629018164174116302881631311164173716418901642272,203081,201572,1629018,1627752,1641741,1642272,1630288,1631311,1641737,1641890,4,3,1,2,3,5,670
1629018163028816313111641741164227216311571641737164174816418901642358,1629018,1641741,1642272,1630288,1631311,1641737,1641890,1631157,1641748,1642358,2,2,0,1,0,1,287
1630288163131116417371641741164227216306991631157164174816418901642358,1641741,1642272,1630288,1631311,1641737,1641890,1631157,1641748,1642358,1630699,2,2,0,1,1,2,373
1627751162837816283861629636162973116301931630534163056716305961641711,1628378,1628386,1629636,1629731,1630596,1627751,1630193,1630534,1630567,1641711,16,11,5,11,11,22,3340
1627751162838616296361629731163019316277471628449163024116305341641711,1628386,1629636,1629731,1627751,1630193,1630534,1641711,1627747,1630241,1628449,1,3,-2,2,3,5,840
1627751162838616296361629731163053416277471628449163024116305581641711,1628386,1629636,1629731,1627751,1630534,1641711,1627747,1630241,1628449,1630558,7,6,1,4,3,7,970
1627747162838616284491630241164171116277771628378162898116305581642347,1628386,1641711,1627747,1630241,1628449,1630558,1627777,1628378,1628981,1642347,3,2,1,2,3,5,400
1627747162777716284491630241163055816283781628981163056716305961642347,1627747,1630241,1628449,1630558,1627777,1628378,1628981,1642347,1630596,1630567,5,11,-6,6,5,11,1650
1627777162837816284491630241163055816289811630171163056716305961642347,1630241,1628449,1630558,1627777,1628378,1628981,1642347,1630596,1630567,1630171,0,6,-6,3,3,6,780
1627777162837816284491630241163055816301711630567163059616417111642367,1630241,1628449,1630558,1627777,1628378,1630596,1630567,1630171,1641711,1642367,0,2,-2,1,2,3,620
1627777162837816284491630241163059616301711630193163056716417111642367,1630241,1628449,1627777,1628378,1630596,1630567,1630171,1641711,1642367,1630193,3,2,1,2,1,3,360
1627777162837816301711630567163059616277511629660163019316417111642367,1627777,1628378,1630596,1630567,1630171,1641711,1642367,1630193,1629660,1627751,2,4,-2,1,2,3,470
1628378163017116301931630596164171116277511629660162973116305341630558,1628378,1630596,1630171,1641711,1630193,1629660,1627751,1629731,1630534,1630558,2,2,0,2,1,3,420
1628378162966016301711630193164171116277511628386162973116305341630558,1628378,1630171,1641711,1630193,1629660,1627751,1629731,1630534,1630558,1628386,2,0,2,3,3,6,690
1627751162966016301711630193164171116283861629636162973116305341630558,1630171,1641711,1630193,1629660,1627751,1629731,1630534,1630558,1628386,1629636,4,2,2,3,4,7,880
1627751162966016297311630193164171116277471628386162963616305341630567,1641711,1630193,1629660,1627751,1629731,1630534,1628386,1629636,1627747,1630567,1,2,-1,2,1,3,390
1627751162966016297311630193164171116277471628378162838616305341630567,1641711,1630193,1629660,1627751,1629731,1630534,1628386,1627747,1630567,1628378,0,7,-7,4,4,8,740
1627751162966016301931630534164171116277471628378162838616305671630596,1641711,1630193,1629660,1627751,1630534,1628386,1627747,1630567,1628378,1630596,0,0,0,1,2,3,410
1627751162838616296601630534164171116277471628378163056716305961642347,1641711,1629660,1627751,1630534,1628386,1627747,1630567,1628378,1630596,1642347,3,9,-6,6,4,10,1440
1627751162838616305341630567164171116283781629636162973116305581630596,1641711,1627751,1630534,1628386,1630567,1628378,1630596,1629636,1629731,1630558,7,8,-1,5,6,11,2050
1627751162837816283861630534163056716296361629731163055816305961642347,1627751,1630534,1628386,1630567,1628378,1630596,1629636,1629731,1630558,1642347,0,6,-6,3,3,6,880
1627751162837816283861629636163056716277471628449162973116423471642419,1627751,1628386,1630567,1628378,1629636,1629731,1642347,1627747,1628449,1642419,1,0,1,1,0,1,250
1627751162838616296361629731163056716277471628449163024116423471642419,1627751,1628386,1630567,1629636,1629731,1642347,1627747,1628449,1642419,1630241,0,2,-2,2,2,4,370
1627751162838616296361630567164234716277471627777162844916302411642419,1627751,1628386,1630567,1629636,1642347,1627747,1628449,1642419,1630241,1627777,2,0,2,0,0,0,110
1627747162775116283861629636164234716277771628449163024116417111642419,1627751,1628386,1629636,1642347,1627747,1628449,1642419,1630241,1627777,1641711,8,7,1,5,6,11,1440
1627747162838616284491629636164234716277771628981163024116417111642419,1628386,1629636,1642347,1627747,1628449,1642419,1630241,1627777,1641711,1628981,3,1,2,2,1,3,450
1627747162844916296361630241164234716277771628981163056716305961641711,1629636,1642347,1627747,1628449,1630241,1627777,1641711,1628981,1630596,1630567,9,12,-3,6,7,13,1650
1627747162777716284491628981163059616283781630171163053416305581642419,1627747,1628449,1627777,1628981,1630596,1628378,1630171,1630534,1630558,1642419,4,4,0,4,3,7,1270
1627777162837816284491628981163059616296601630171163053416305581642419,1628449,1627777,1628981,1630596,1628378,1630171,1630534,1630558,1642419,1629660,2,5,-3,2,3,5,650
1627777162837816284491630171163059616296601630534163055816423671642419,1628449,1627777,1630596,1628378,1630171,1630534,1630558,1642419,1629660,1642367,0,2,-2,2,1,3,180
16277771629660163017116423671642419202066202684162898116418541642347,1627777,1630171,1642419,1629660,1642367,202684,1641854,202066,1628981,1642347,5,2,3,3,4,7,1100
20268416296601630171164236716424192020661628981164185416422811642347,1630171,1642419,1629660,1642367,202684,1641854,202066,1628981,1642347,1642281,3,5,-2,2,2,4,710
20268416296601630171164236716424192020661628981163055816418541642281,1630171,1642419,1629660,1642367,202684,1641854,202066,1628981,1642281,1630558,5,1,4,2,2,4,590
20268416296601630171164236716424192020661630558164185416422791642281,1630171,1642419,1629660,1642367,202684,1641854,202066,1642281,1630558,1642279,8,12,-4,10,9,19,2700
